

NO texture/1bd.xpm                   
WE texture/1bd.xpm
F 220,100,0 
SO texture/1bd.xpm
EA                         texture/1bd.xpm                         
C 0  ,10,  0                                                        

111111
110N01
111111
