NO ./1bd.xpm
WE ./1bd.xpm
F 220,100,0
SO ./1bd.xpm
EA                         ./1bd.xpm
C 0  ,10,  0

111111111111111111111111
100000000000000000000001
100000001100011011100001
100000011000010011100001
100000110000000111000001
10000110000N001110000001
100011000000011100000001
100111111110011100100001
100000001110011101100001
100000001110000000000001
100000000000000000000001
111111111111111111111111