NO ./1bd.xpm
WE ./1bd.xpm
F 220,100,0
SO ./1bd.xpm
EA                         ./1bd.xpm
C 0  ,10,  0

1111
11101
10101
10N01
1111