NO ./1bd.xpm
WE ./1bd.xpm
F 220,100,0
SO ./1bd.xpm
EA                         ./1bd.xpm
C 0  ,10,  0










111111111111111111111111111111111
100000001000000000110000000000001
100000001011000001110000000000001
100000001001000000000000000000001
100000001011000001110000000000001
100000000011000001110111111111111
11110111111111011100000010001
11110111111111011101010010001
110000001101010111000N0000001
1000000000000000110000001000111
1000000000000000110101001000100
1100000111010101111101111001001
11111111 1111111 101111111111111
