NO ./1bd.xpm
WE ./1bd.xpm
F 220,100,0
SO ./1bd.xpm
EA                         ./1bd.xpm
C 0  ,10,  0




111111111111111111111111111111111
100000001000000000110000000000001
100000001011000001110000000000001
100000000000000N00000000000000001
100000001011000001110000000000001
111111111111111111111111111111111

