WE texture/Wall.xpm
NO texture/North.xpm
SO texture/Wall.xpm
EA texture/Wall.xpm


C 0, 152, 10
F 56, 0, 72

 111111111111111111111111111111111111111111111111111111111111111111111111
1N000000000000000000000000000000000000000000000000000000000000000000000001
 111111111111111111111111111111111111111111111111111111111111111111111111
