NO texture/North.xpm
        SO texture/South.xpm
        WE texture/Wall.xpm
        EA texture/SusMap1.xpm
        C 69,0,120
        F 23,222,1

1111111111
1001010001
1100000001
1001001001
1010100001
1001110001
1000000001
1010S01101
1000000001
1111111111
