         NO ./texture/1bd.xpm
WE ./texture/1bd.xpm
SO ./texture/1bd.xpm
EA                         ./texture/1bd.xpm

F     220,100,201
C 225,30,0

        1111111111111111111111111111
        100000000011000000000000101
        1011000001110000000000001111
        1001000000000000000000001
111111111011000001110000000000001
100000000011000001110111111111111
11110111111111011100000010001
11110111111111011101010010001
11000000110101011100000010001
10000000000000001100000010001
10000000000000001101010000001
11000001110101011111011110N0111
11110111 1110101 101111010001
11111111 1111111 111111111111
